1111111111111
11111P11111C1
1000001000101
10111010N0C01
1C10000001101
1000111100001
1010111100111
1010011C00001
10C1011111001
11110000C10E1
1111111111111
