1111111111111111111
1000000000C000000E1
1000000N00000000001
1000000000000000001
10000C0C0C0C0000001
100N0C0C0C0C0000001
10000C0C0C0C0000001
10000C0C0C0C000N001
10000C0C0P0C0000011
10000C0C0C0C0000001
10000C0C0C0C00000E1
1111111111111111111
