11111
1P0E1
1CCC1
1N001
11111
