1111111111111111
1011110111111111
1111P000001111
1010011101111111
1000011C00000001
1000110001E11111
1111111111111111
